-._.-._.-._.-._.-._.-._.-._.-._.-._.-._.-._.-._.-._.-._.-._.-._.-._.-._.-._.-._.
-._.-._____.-._.-._.-._.-._.-._.-._.-._.-._.-._.-._.-._.-._.-._.-._.-._.-._.-._.
-._.-_|░░░░|-._.-._.-._.-._.-._.-._.-._.-._.-._.-._.-._.-._.-._.-._.-._.-._.-._.
-.__|░░░░░░░|._.-._.-._.-._.-._.-._.-._.-._.-._.-._.-._.-._.-._.-._.-._.-._.-._.
-._|░░░░░░░░░|_.-._.-._.-._.-._.-._.-._.-._.-._.-._.-._.-._.-._.-._.-._.-._.-._.
-._|░░░░░░░░░|_.-._.-._.-._.-._.-._.-._.-._.-._.-._.-._.-._.-._.-._.-._.-._.-._.
-._.|░░░░░░|┘._.-._.-._.-._.-._.-._.-._.-._.-._.-._.-._.-._.-._.-._.-._.-._.-._.
-._.-└|░░░|.-._.-._.-._.-._.-._.-._.-._.-._.-._.-._.-._.-._.-._.-._.-._.-._.-.._
-._.-._▀▀▀_._._.-._.-._.-._.-._.-._.-._.-._.-._.-._.-._.-._.-._.-._.-._.-._.__|░
-._.-._.-._.-._.-._.-._.-._.-._.-._.-._.-._.-._.-._.-._.-._.-._.-._.-..____|░░░░
-._.-._.-._.-._.-._.-._.-._.-._.-._.-._.-._.-._.-._.-._.-._.._________|░░░░░░░░░
-._.-._.-._.-._.-._.-._.-._.-._.-._.-._.-._.-._.-._.-._.-.__|░░░░░░░░░░░░░░░░░░░
-._.-._.-._.-._.-._.-._.-._.-._.-._.-._.-._.-._.-._._____|░░░░░░░░░░░░░░░░░░░░░░
-._.-._.-._.-._.-._.-._.-._.-._.-._.-._.-._.-..____|░░░░░░░░░░░░░░░░░░░░░░░░░░░░
-._.-._.-._.-._.-._.-._.-._.-._.-._.-._.-._.-┌|░░░░░░░░░░░░░░░░░░░░░░░░░░░░░░░░░
-._.-._.-._.-._.-._.-._.-._.-._.-._.-._.-._.-|░░░░░░░░░░░░░░░░░░░░░░░░░░░░░░░░░░
-._.-._.-._.-._.-._.-._.-._.-._.-._.-._.-._.-└|░░░░░░░░░░░░░░░░░░░░░░░░░░░░░░░░░
-._.-._.-._.-._.-._.-._.-._.-._.-._.-._.-._.-.└|░░░░░░░░░░░░░░░░░░░░░░░░░░░░░░░░
-._.-._.-._.-._.-._.-._.-._.-._.-._.-._.-._.-._|░░░░░░░░░░░░░░░░░░░░░░░░░░░░░░░░
-._.-._.-._.-._.-._.-._.-._.-._.-._.-._.-._.-._└|░░░░░░░░░░░░░░░░░░░░░░░░░░░░░░░
