ABCBABCBABCBABCBABCBABCBABCBABCBABCBABCBABCBABCBABCBABCBABCBABCBABCBABCBABCBABCB
ABCBABCCCCCBABCBABCBABCBABCBABCBABCBABCBABCBABCBABCBABCBABCBABCBABCBABCBABCBABCB
ABCBACEDDDDEABCBABCBABCBABCBABCBABCBABCBABCBABCBABCBABCBABCBABCBABCBABCBABCBABCB
ABCCEDDDDDDDEBCBABCBABCBABCBABCBABCBABCBABCBABCBABCBABCBABCBABCBABCBABCBABCBABCB
ABCEDDDDDDDDDECBABCBABCBABCBABCBABCBABCBABCBABCBABCBABCBABCBABCBABCBABCBABCBABCB
ABCEDDDDDDDDDECBABCBABCBABCBABCBABCBABCBABCBABCBABCBABCBABCBABCBABCBABCBABCBABCB
ABCBEDDDDDDEHBCBABCBABCBABCBABCBABCBABCBABCBABCBABCBABCBABCBABCBABCBABCBABCBABCB
ABCBAIEDDDEBABCBABCBABCBABCBABCBABCBABCBABCBABCBABCBABCBABCBABCBABCBABCBABCBABBC
ABCBABCFFFCBCBCBABCBABCBABCBABCBABCBABCBABCBABCBABCBABCBABCBABCBABCBABCBABCBCCED
ABCBABCBABCBABCBABCBABCBABCBABCBABCBABCBABCBABCBABCBABCBABCBABCBABCBABBCCCCEDDDD
ABCBABCBABCBABCBABCBABCBABCBABCBABCBABCBABCBABCBABCBABCBABCBBCCCCCCCCCEDDDDDDDDD
ABCBABCBABCBABCBABCBABCBABCBABCBABCBABCBABCBABCBABCBABCBABCCEDDDDDDDDDDDDDDDDDDD
ABCBABCBABCBABCBABCBABCBABCBABCBABCBABCBABCBABCBABCBCCCCCEDDDDDDDDDDDDDDDDDDDDDD
ABCBABCBABCBABCBABCBABCBABCBABCBABCBABCBABCBABBCCCCEDDDDDDDDDDDDDDDDDDDDDDDDDDDD
ABCBABCBABCBABCBABCBABCBABCBABCBABCBABCBABCBAGEDDDDDDDDDDDDDDDDDDDDDDDDDDDDDDDDD
ABCBABCBABCBABCBABCBABCBABCBABCBABCBABCBABCBAEDDDDDDDDDDDDDDDDDDDDDDDDDDDDDDDDDD
ABCBABCBABCBABCBABCBABCBABCBABCBABCBABCBABCBAIEDDDDDDDDDDDDDDDDDDDDDDDDDDDDDDDDD
ABCBABCBABCBABCBABCBABCBABCBABCBABCBABCBABCBABIEDDDDDDDDDDDDDDDDDDDDDDDDDDDDDDDD
ABCBABCBABCBABCBABCBABCBABCBABCBABCBABCBABCBABCEDDDDDDDDDDDDDDDDDDDDDDDDDDDDDDDD
ABCBABCBABCBABCBABCBABCBABCBABCBABCBABCBABCBABCIEDDDDDDDDDDDDDDDDDDDDDDDDDDDDDDD
